111111111111
100001000001
100000F00E01
1P0000000001
111111111111
