111111111111
1P00000000E1
100011100001
1C0000000001
100011100001
100011100001
100011100001
100011100001
111111111111
