111111111111
1P0000C000E1
100011100001
1C00C0000C01
1000111001C1
111111111111
