111111111111
1P0000C000E1
100011100001
1C01C1000C01
1000111000C1
111111111111