111111111111
1P0000C00101
1000111001E1
1C00C0000C01
1000111001C1
111111111111
