111111111111
1P00C00C00E1
100000000001
1C00C00C0001
111111111111