111111111111
100000C00001
10E011110P01
1C00C1101C01
1000111000C1
111111111111