1111111111111111
1P1C0C1C1C0001E1
1C1010101000C101
101C101010000101
10101010100C01C1
1010101010000001
1000100000000C01
100C1110C0000C01
1000111100000C01
1000111110000C01
1C00000C11000C01
1111111111111111
