1111111111
1P0C0C0C01
1C0C0C0C01
1C0C0C0C01
1C0C0C0C01
1C0C0C0CE1
1111111111
