111111
1P00E1
100C01
1C0001
111111
