1111111111111111
1P1C0C1C100001E1
1C1010101000C101
101C101010000101
1C101010100C01C1
1010101010000001
1C00000000000C01
1111111111111111
